SOU	= "countries/Souiet Union.txt"
NAF = "countries/Russian North America.txt"
CAF	= "countries/Russian Central America.txt"
SAR	= "countries/Russian South America.txt"
CAI	= "countries/Russian Caribbean.txt"
MEF	= "countries/Middle East Russia.txt"
AFF	= "countries/Africa Russia.txt"
SFR	= "countries/South Asia Russia.txt"
SEA	= "countries/South East Asia Russia.txt"
EAR	= "countries/East Asia Russia.txt"
OCE	= "countries/Oceania Russia.txt"
EUR	= "countries/Europe Russia.txt"
BRN	= "countries/Brandenburg.txt"
POM	= "countries/Pomerania.txt"
TEU	= "countries/Teutonic.txt"
SIL	= "countries/Silesian.txt"
THU	= "countries/Thuringia.txt"
HES	= "countries/Hesse.txt"
TRE	= "countries/Trier.txt"
CLG	= "countries/Cologne.txt"
SHI	= "countries/Shimazu.txt"
HOS	= "countries/Hosokawa.txt"
MOI	= "countries/Mori.txt"
ODA	= "countries/Oda.txt"
TOK	= "countries/Tokugawa.txt"
MDE	= "countries/Maeda.txt"
UES	= "countries/Uesugi.txt"
SHB	= "countries/Shiba.txt"
AIN	= "countries/Ainu.txt"
RYU	= "countries/Ryukyu.txt"
SIB = "countries/Siberia.txt"
KAR = "countries/Karelia.txt"